23 50
--------------------------------------------------
-------OOOOOOOOOOOOOOOOOOOOOOOOOOOOOO--------O----
-------O--------------O-------------O--------O----
-------O--------------O---OOOOOOOOO-O---OOOOOO----
SOOOOOOO--------------O--OO-------O-O---O----O----
-------O---OOOOOOOOO--O-OO--------OOOOOOO----O----
-------O---O-------O--O-O--------------------O----
---OOOOO---O-------O--OOO--------------------O----
-------O---O-------O-------------------------O----
-------O---O--OOOOOOOOOOOOOOOOOOOOO----------O----
---OOOOO---O--O----O----O--------------------O----
---O----------O----O----OOOOOOOOOOOOOOO------O----
---OOOOOOO----O----O-------------------------O----
---O----------O----O------O------------------O----
---OOOOOOOOOOOO----OOOOOOOOOOO--O------------O----
--------O----------O------O-----O------------O----
--------O----------O------O-----OOOOOO-------O----
--------OOOOOO-----O------------O----O-------O----
-------------------OOOOOOOOOOOOOO----OOOOO---O----
-------------------------O-----------O-------O----
-------------------------O-----------O------------
-------------------------O-----------OOOOOOOOOOOOF
--------------------------------------------------
